[0, 0, 0, 0, 0, 0, 0, 0, 0, 0, 0, 0, 0, 0, 0, 0, 0, 0, 0, 0, 0, 0, 0, 0, 0, 0, 0, 0, 0, 0]
[0, 0, 0, 0, 0, 0, 0, 0, 0, 0, 0, 0, 0, 0, 0, 0, 0, 0, 0, 0, 0, 0, 0, 0, 0, 0, 0, 0, 0, 0]
[0, 0, 0, 0, 0, 0, 0, 0, 0, 0, 0, 0, 0, 0, 0, 1, 1, 1, 1, 1, 1, 1, 1, 1, 1, 1, 1, 1, 0, 0]
[0, 0, 0, 0, 0, 0, 0, 0, 0, 0, 0, 0, 0, 0, 0, 1, 1, 1, 1, 1, 1, 1, 1, 1, 1, 1, 1, 1, 0, 0]
[1, 1, 1, 1, 1, 1, 1, 1, 1, 1, 1, 0, 0, 0, 0, 1, 1, 5, 4, 4, 4, 4, 4, 4, 4, 5, 1, 1, 0, 0]
[1, 1, 1, 1, 1, 1, 1, 1, 1, 1, 1, 0, 0, 0, 0, 1, 1, 4, 1, 1, 1, 1, 1, 1, 1, 4, 1, 1, 0, 0]
[2, 4, 4, 4, 4, 4, 4, 4, 5, 1, 1, 0, 0, 0, 0, 1, 1, 4, 1, 1, 1, 1, 1, 1, 1, 4, 1, 1, 0, 0]
[1, 1, 1, 1, 1, 1, 1, 1, 4, 1, 1, 0, 0, 0, 0, 1, 1, 4, 1, 1, 0, 0, 0, 1, 1, 4, 1, 1, 0, 0]
[1, 1, 1, 1, 1, 1, 1, 1, 4, 1, 1, 0, 0, 0, 0, 1, 1, 4, 1, 1, 0, 0, 0, 1, 1, 4, 1, 1, 0, 0]
[0, 0, 0, 0, 0, 0, 1, 1, 4, 1, 1, 0, 0, 0, 0, 1, 1, 4, 1, 1, 0, 0, 0, 1, 1, 4, 1, 1, 0, 0]
[0, 0, 0, 0, 0, 0, 1, 1, 4, 1, 1, 0, 0, 0, 0, 1, 1, 4, 1, 1, 0, 0, 0, 1, 1, 4, 1, 1, 0, 0]
[0, 0, 0, 0, 0, 0, 1, 1, 4, 1, 1, 0, 0, 0, 0, 1, 1, 4, 1, 1, 0, 0, 0, 1, 1, 4, 1, 1, 0, 0]
[0, 0, 0, 0, 0, 0, 1, 1, 4, 1, 1, 0, 0, 0, 0, 1, 1, 4, 1, 1, 0, 0, 0, 1, 1, 4, 1, 1, 0, 0]
[1, 1, 1, 1, 1, 1, 1, 1, 4, 1, 1, 0, 0, 0, 0, 1, 1, 4, 1, 1, 0, 0, 0, 1, 1, 4, 1, 1, 0, 0]
[1, 1, 1, 1, 1, 1, 1, 1, 4, 1, 1, 0, 0, 0, 0, 1, 1, 4, 1, 1, 0, 0, 0, 1, 1, 4, 1, 1, 0, 0]
[1, 1, 5, 4, 4, 4, 4, 4, 5, 1, 1, 0, 0, 0, 0, 1, 1, 4, 1, 1, 0, 0, 0, 1, 1, 4, 1, 1, 0, 0]
[1, 1, 4, 1, 1, 1, 1, 1, 1, 1, 1, 0, 0, 0, 0, 1, 1, 4, 1, 1, 0, 0, 0, 1, 1, 4, 1, 1, 0, 0]
[1, 1, 4, 1, 1, 1, 1, 1, 1, 1, 1, 0, 0, 0, 0, 1, 1, 4, 1, 1, 0, 0, 0, 1, 1, 4, 1, 1, 1, 1]
[1, 1, 4, 1, 1, 0, 0, 0, 0, 0, 0, 0, 0, 0, 0, 1, 1, 4, 1, 1, 0, 0, 0, 1, 1, 4, 1, 1, 1, 1]
[1, 1, 4, 1, 1, 0, 0, 0, 0, 0, 0, 0, 0, 0, 0, 1, 1, 4, 1, 1, 0, 0, 0, 1, 1, 5, 4, 4, 3, 1]
[1, 1, 4, 1, 1, 0, 0, 0, 0, 0, 0, 0, 0, 0, 0, 1, 1, 4, 1, 1, 0, 0, 0, 1, 1, 1, 1, 1, 1, 1]
[1, 1, 4, 1, 1, 0, 0, 0, 0, 0, 0, 0, 0, 0, 0, 1, 1, 4, 1, 1, 0, 0, 0, 1, 1, 1, 1, 1, 1, 1]
[1, 1, 4, 1, 1, 0, 0, 0, 0, 0, 0, 0, 0, 0, 0, 1, 1, 4, 1, 1, 0, 0, 0, 0, 0, 0, 0, 0, 0, 0]
[1, 1, 4, 1, 1, 0, 0, 0, 0, 0, 0, 0, 0, 0, 0, 1, 1, 4, 1, 1, 0, 0, 0, 0, 0, 0, 0, 0, 0, 0]
[1, 1, 4, 1, 1, 0, 0, 0, 0, 0, 0, 0, 0, 0, 0, 1, 1, 4, 1, 1, 0, 0, 0, 0, 0, 0, 0, 0, 0, 0]
[1, 1, 4, 1, 1, 0, 0, 0, 0, 0, 0, 0, 0, 0, 0, 1, 1, 4, 1, 1, 0, 0, 0, 0, 0, 0, 0, 0, 0, 0]
[1, 1, 4, 1, 1, 1, 1, 1, 1, 1, 1, 1, 1, 1, 1, 1, 1, 4, 1, 1, 0, 0, 0, 0, 0, 0, 0, 0, 0, 0]
[1, 1, 5, 4, 4, 4, 4, 4, 4, 4, 4, 4, 4, 4, 4, 4, 4, 5, 1, 1, 0, 0, 0, 0, 0, 0, 0, 0, 0, 0]
[1, 1, 1, 1, 1, 1, 1, 1, 1, 1, 1, 1, 1, 1, 1, 1, 1, 1, 1, 1, 0, 0, 0, 0, 0, 0, 0, 0, 0, 0]
[1, 1, 1, 1, 1, 1, 1, 1, 1, 1, 1, 1, 1, 1, 1, 1, 1, 1, 1, 1, 0, 0, 0, 0, 0, 0, 0, 0, 0, 0]
